"year","month","brand","ytd_electric_registrations","ytd_hybrid_registrations","ytd_plugin_registrations","ytd_diesel_plugin_registrations","ytd_registrations"
2023,1,"BYDAUTO",2999,0,0,0,2999
2023,1,"TOYOTA",31,2153,24,0,2208
2023,1,"HYUNDAI",773,1226,0,0,1999
2023,1,"KIA",285,120,899,0,1304
2023,1,"SUZUKI",0,1294,0,0,1294
2023,1,"MG",80,0,1203,0,1283
2023,1,"GEELY",1200,0,0,0,1200
2023,1,"MERCEDES_BENZ",389,0,288,44,721
2023,1,"BMW",23,0,247,0,270
2023,1,"LEXUS",0,167,63,0,230
2023,1,"SERES",174,0,0,0,174
2023,1,"VOLVO",83,0,74,0,157
2023,1,"SKYWELL",151,0,0,0,151
2023,1,"SKODA",118,0,9,0,127
2023,1,"FIAT",122,0,0,0,122
2023,1,"LEAPMOTOR",99,0,0,0,99
2023,1,"GENESIS",83,0,0,0,83
2023,1,"MAXUS",80,0,0,0,80
2023,1,"AUDI",58,1,8,0,67
2023,1,"HONDA",0,51,0,0,51
2023,1,"AIWAYS",41,0,0,0,41
2023,1,"POLESTAR",41,0,0,0,41
2023,1,"HONGQI",39,0,0,0,39
2023,1,"WEY",0,0,26,0,26
2023,1,"NISSAN",0,20,0,0,20
2023,1,"RENAULT",0,20,0,0,20
2023,1,"JAC",17,0,0,0,17
2023,1,"MINI",3,0,11,0,14
2023,1,"PORSCHE",10,0,2,0,12
2023,1,"LYNKCO",0,0,9,0,9
2023,1,"MITSUBISHI",0,0,8,0,8
2023,1,"CITROEN",8,0,0,0,8
2023,1,"PEUGEOT",4,0,4,0,8
2023,1,"VOYAH",6,0,0,0,6
2023,1,"OPEL",5,0,0,0,5
2023,1,"TESLA",3,0,0,0,3
2023,1,"VOLKSWAGEN",2,0,0,0,2
2023,1,"LAND_ROVER",0,0,1,0,1
2023,1,"JAGUAR",0,0,1,0,1
2023,2,"BYDAUTO",4590,0,0,0,4590
2023,2,"TOYOTA",115,4333,81,0,4529
2023,2,"HYUNDAI",1010,2397,0,0,3407
2023,2,"GEELY",2200,0,0,0,2200
2023,2,"SUZUKI",0,2075,0,0,2075
2023,2,"KIA",328,159,1514,0,2001
2023,2,"MG",100,0,1435,0,1535
2023,2,"MERCEDES_BENZ",441,0,356,53,850
2023,2,"LEXUS",0,275,117,0,392
2023,2,"BMW",40,0,321,0,361
2023,2,"SERES",355,0,0,0,355
2023,2,"SKYWELL",296,0,0,0,296
2023,2,"VOLVO",139,0,147,0,286
2023,2,"HONDA",0,236,0,0,236
2023,2,"SKODA",201,0,10,0,211
2023,2,"AIWAYS",173,0,0,0,173
2023,2,"GENESIS",163,0,0,0,163
2023,2,"FIAT",138,0,0,0,138
2023,2,"LEAPMOTOR",132,0,0,0,132
2023,2,"WEY",0,0,117,0,117
2023,2,"MAXUS",106,0,0,0,106
2023,2,"AUDI",89,1,15,0,105
2023,2,"POLESTAR",57,0,0,0,57
2023,2,"LYNKCO",0,0,56,0,56
2023,2,"HONGQI",54,0,0,0,54
2023,2,"NISSAN",0,49,0,0,49
2023,2,"ORA",48,0,0,0,48
2023,2,"RENAULT",0,39,0,0,39
2023,2,"PEUGEOT",10,0,17,0,27
2023,2,"CITROEN",27,0,0,0,27
2023,2,"OPEL",26,0,0,0,26
2023,2,"VOYAH",25,0,0,0,25
2023,2,"JAC",24,0,0,0,24
2023,2,"PORSCHE",14,0,3,0,17
2023,2,"MINI",3,0,13,0,16
2023,2,"DS_AUTOMOBILES",3,0,10,0,13
2023,2,"LAND_ROVER",0,0,9,0,9
2023,2,"MITSUBISHI",0,0,8,0,8
2023,2,"VOLKSWAGEN",6,0,0,0,6
2023,2,"LEVC",5,0,0,0,5
2023,2,"FERRARI",0,0,3,0,3
2023,2,"TESLA",3,0,0,0,3
2023,2,"EVEASY",2,0,0,0,2
2023,2,"JAGUAR",0,0,1,0,1
2023,2,"SEAT",0,0,0,0,0
2023,2,"MASERATI",0,0,0,0,0
2023,2,"CUPRA",0,0,0,0,0
2023,2,"INFINITI",0,0,0,0,0
2023,2,"ALFA_ROMEO",0,0,0,0,0
2023,2,"BENTLEY",0,0,0,0,0
2023,2,"ABARTH",0,0,0,0,0
2023,2,"MAZDA",0,0,0,0,0
2023,2,"FORD",0,0,0,0,0
2023,2,"JEEP",0,0,0,0,0
2023,2,"ASTON_MARTIN",0,0,0,0,0
2023,2,"SUBARU",0,0,0,0,0
2023,2,"CADILLAC",0,0,0,0,0
2023,2,"CHEVROLET",0,0,0,0,0
2023,2,"ISUZU",0,0,0,0,0
2023,2,"DACIA",0,0,0,0,0
2023,2,"CHERY",0,0,0,0,0
2023,2,"SSANGYONG",0,0,0,0,0
2023,3,"TOYOTA",242,6024,93,0,6359
2023,3,"BYDAUTO",5852,0,0,0,5852
2023,3,"HYUNDAI",1752,3550,0,0,5302
2023,3,"GEELY",3102,0,0,0,3102
2023,3,"KIA",384,184,2505,0,3073
2023,3,"SUZUKI",0,3051,0,0,3051
2023,3,"MG",129,0,1622,0,1751
2023,3,"TESLA",1369,0,0,0,1369
2023,3,"MERCEDES_BENZ",493,0,387,58,938
2023,3,"LEXUS",4,377,171,0,552
2023,3,"BMW",64,0,395,0,459
2023,3,"SERES",439,0,0,0,439
2023,3,"SKODA",409,0,23,0,432
2023,3,"SKYWELL",375,0,0,0,375
2023,3,"VOLVO",172,0,194,0,366
2023,3,"HONDA",0,274,0,0,274
2023,3,"AIWAYS",255,0,0,0,255
2023,3,"GENESIS",252,0,0,0,252
2023,3,"LEAPMOTOR",204,0,0,0,204
2023,3,"WEY",0,0,181,0,181
2023,3,"ORA",178,0,0,0,178
2023,3,"AUDI",146,2,22,0,170
2023,3,"FIAT",148,0,0,0,148
2023,3,"NISSAN",0,127,0,0,127
2023,3,"MAXUS",123,0,0,0,123
2023,3,"LYNKCO",0,0,112,0,112
2023,3,"HONGQI",71,0,0,0,71
2023,3,"POLESTAR",63,0,0,0,63
2023,3,"RENAULT",0,59,0,0,59
2023,3,"VOLKSWAGEN",57,0,0,0,57
2023,3,"VOYAH",55,0,0,0,55
2023,3,"CITROEN",48,0,0,0,48
2023,3,"PEUGEOT",16,0,28,0,44
2023,3,"MINI",4,0,26,0,30
2023,3,"OPEL",30,0,0,0,30
2023,3,"JAC",28,0,0,0,28
2023,3,"PORSCHE",18,0,6,0,24
2023,3,"DS_AUTOMOBILES",4,0,17,0,21
2023,3,"LAND_ROVER",0,0,11,0,11
2023,3,"MITSUBISHI",0,0,8,0,8
2023,3,"EVEASY",7,0,0,0,7
2023,3,"LEVC",7,0,0,0,7
2023,3,"FERRARI",0,0,6,0,6
2023,3,"JAGUAR",0,0,1,0,1
2023,3,"ABARTH",0,0,0,0,0
2023,3,"CUPRA",0,0,0,0,0
2023,3,"JEEP",0,0,0,0,0
2023,3,"MASERATI",0,0,0,0,0
2023,3,"SUBARU",0,0,0,0,0
2023,3,"SEAT",0,0,0,0,0
2023,3,"CHERY",0,0,0,0,0
2023,3,"INFINITI",0,0,0,0,0
2023,3,"DACIA",0,0,0,0,0
2023,3,"BENTLEY",0,0,0,0,0
2023,3,"ASTON_MARTIN",0,0,0,0,0
2023,3,"MAZDA",0,0,0,0,0
2023,3,"FORD",0,0,0,0,0
2023,3,"MAN",0,0,0,0,0
2023,3,"ALFA_ROMEO",0,0,0,0,0
2023,3,"CADILLAC",0,0,0,0,0
2023,3,"CHEVROLET",0,0,0,0,0
2023,3,"ISUZU",0,0,0,0,0
2023,3,"SSANGYONG",0,0,0,0,0
2023,4,"TOYOTA",350,7276,122,0,7748
2023,4,"BYDAUTO",7229,0,0,0,7229
2023,4,"HYUNDAI",2012,4744,0,0,6756
2023,4,"KIA",454,231,3179,0,3864
2023,4,"SUZUKI",0,3782,0,0,3782
2023,4,"GEELY",3639,0,0,0,3639
2023,4,"MG",178,0,1750,0,1928
2023,4,"TESLA",1441,0,0,0,1441
2023,4,"MERCEDES_BENZ",637,0,439,63,1139
2023,4,"LEXUS",4,431,209,0,644
2023,4,"SKODA",548,0,29,0,577
2023,4,"BMW",89,0,427,0,516
2023,4,"SERES",481,0,0,0,481
2023,4,"SKYWELL",422,0,0,0,422
2023,4,"VOLVO",200,0,219,0,419
2023,4,"AIWAYS",355,0,0,0,355
2023,4,"ORA",322,0,0,0,322
2023,4,"HONDA",0,292,0,0,292
2023,4,"GENESIS",273,0,0,0,273
2023,4,"NISSAN",0,269,0,0,269
2023,4,"LEAPMOTOR",252,0,0,0,252
2023,4,"WEY",0,0,229,0,229
2023,4,"AUDI",168,2,25,0,195
2023,4,"VOLKSWAGEN",174,0,0,0,174
2023,4,"FIAT",163,0,0,0,163
2023,4,"MAXUS",152,0,0,0,152
2023,4,"LYNKCO",0,0,147,0,147
2023,4,"HONGQI",74,0,0,0,74
2023,4,"RENAULT",0,73,0,0,73
2023,4,"POLESTAR",68,0,0,0,68
2023,4,"VOYAH",66,0,0,0,66
2023,4,"CITROEN",62,0,0,0,62
2023,4,"JAC",56,0,0,0,56
2023,4,"PEUGEOT",16,0,33,0,49
2023,4,"OPEL",38,0,0,0,38
2023,4,"MINI",5,0,31,0,36
2023,4,"DS_AUTOMOBILES",6,0,22,0,28
2023,4,"PORSCHE",19,0,7,0,26
2023,4,"LEVC",20,0,0,0,20
2023,4,"LAND_ROVER",0,0,17,0,17
2023,4,"EVEASY",9,0,0,0,9
2023,4,"MITSUBISHI",0,0,8,0,8
2023,4,"FERRARI",0,0,6,0,6
2023,4,"CUPRA",0,0,4,0,4
2023,4,"JAGUAR",0,0,1,0,1
2023,4,"ABARTH",0,0,0,0,0
2023,4,"MAN",0,0,0,0,0
2023,4,"JEEP",0,0,0,0,0
2023,4,"MASERATI",0,0,0,0,0
2023,4,"SUBARU",0,0,0,0,0
2023,4,"SEAT",0,0,0,0,0
2023,4,"CHERY",0,0,0,0,0
2023,4,"INFINITI",0,0,0,0,0
2023,4,"DACIA",0,0,0,0,0
2023,4,"BENTLEY",0,0,0,0,0
2023,4,"ASTON_MARTIN",0,0,0,0,0
2023,4,"MAZDA",0,0,0,0,0
2023,4,"FORD",0,0,0,0,0
2023,4,"CADILLAC",0,0,0,0,0
2023,4,"CHEVROLET",0,0,0,0,0
2023,4,"ISUZU",0,0,0,0,0
2023,4,"ALFA_ROMEO",0,0,0,0,0
2023,4,"SSANGYONG",0,0,0,0,0
2023,5,"TOYOTA",456,9521,145,0,10122
2023,5,"BYDAUTO",8497,0,0,0,8497
2023,5,"HYUNDAI",2618,5701,0,0,8319
2023,5,"KIA",550,289,3988,0,4827
2023,5,"SUZUKI",0,4490,0,0,4490
2023,5,"GEELY",4091,0,0,0,4091
2023,5,"MG",325,0,1848,0,2173
2023,5,"TESLA",1863,0,0,0,1863
2023,5,"MERCEDES_BENZ",718,0,486,68,1272
2023,5,"LEXUS",14,520,259,0,793
2023,5,"SKODA",734,0,41,0,775
2023,5,"BMW",110,0,495,0,605
2023,5,"SERES",512,0,0,0,512
2023,5,"VOLVO",224,0,272,0,496
2023,5,"SKYWELL",464,0,0,0,464
2023,5,"ORA",413,0,0,0,413
2023,5,"NISSAN",0,382,0,0,382
2023,5,"AIWAYS",363,0,0,0,363
2023,5,"GENESIS",321,0,0,0,321
2023,5,"HONDA",0,316,0,0,316
2023,5,"LEAPMOTOR",292,0,0,0,292
2023,5,"VOLKSWAGEN",261,0,0,0,261
2023,5,"WEY",0,0,260,0,260
2023,5,"AUDI",212,2,31,0,245
2023,5,"FIAT",188,0,0,0,188
2023,5,"LYNKCO",0,0,187,0,187
2023,5,"MAXUS",168,0,0,0,168
2023,5,"RENAULT",0,97,0,0,97
2023,5,"CITROEN",91,0,0,0,91
2023,5,"VOYAH",87,0,0,0,87
2023,5,"POLESTAR",80,0,0,0,80
2023,5,"PEUGEOT",40,0,36,0,76
2023,5,"JAC",76,0,0,0,76
2023,5,"HONGQI",75,0,0,0,75
2023,5,"EVEASY",58,0,0,0,58
2023,5,"MITSUBISHI",0,0,48,0,48
2023,5,"OPEL",43,0,0,0,43
2023,5,"MINI",6,0,33,0,39
2023,5,"DS_AUTOMOBILES",6,0,28,0,34
2023,5,"PORSCHE",20,0,7,0,27
2023,5,"LEVC",22,0,0,0,22
2023,5,"LAND_ROVER",0,0,19,0,19
2023,5,"CUPRA",0,0,13,0,13
2023,5,"FERRARI",0,0,7,0,7
2023,5,"WELTMEISTER",3,0,0,0,3
2023,5,"JAGUAR",0,0,1,0,1
2023,5,"FORD",0,0,0,0,0
2023,5,"ABARTH",0,0,0,0,0
2023,5,"JEEP",0,0,0,0,0
2023,5,"MASERATI",0,0,0,0,0
2023,5,"SUBARU",0,0,0,0,0
2023,5,"INFINITI",0,0,0,0,0
2023,5,"SEAT",0,0,0,0,0
2023,5,"CHERY",0,0,0,0,0
2023,5,"DACIA",0,0,0,0,0
2023,5,"BENTLEY",0,0,0,0,0
2023,5,"ASTON_MARTIN",0,0,0,0,0
2023,5,"MAN",0,0,0,0,0
2023,5,"SSANGYONG",0,0,0,0,0
2023,5,"CADILLAC",0,0,0,0,0
2023,5,"CHEVROLET",0,0,0,0,0
2023,5,"ISUZU",0,0,0,0,0
2023,5,"MAZDA",0,0,0,0,0
2023,5,"ALFA_ROMEO",0,0,0,0,0
2023,6,"TOYOTA",541,11904,173,0,12618
2023,6,"HYUNDAI",3134,6992,0,0,10126
2023,6,"BYDAUTO",9698,0,0,0,9698
2023,6,"KIA",600,335,4909,0,5844
2023,6,"SUZUKI",0,5028,0,0,5028
2023,6,"GEELY",4492,0,0,0,4492
2023,6,"TESLA",3298,0,0,0,3298
2023,6,"MG",689,0,1963,0,2652
2023,6,"MERCEDES_BENZ",773,0,516,71,1360
2023,6,"SKODA",908,0,46,0,954
2023,6,"LEXUS",21,605,284,0,910
2023,6,"BMW",163,0,546,0,709
2023,6,"VOLVO",250,0,357,0,607
2023,6,"SERES",565,0,0,0,565
2023,6,"ORA",486,0,0,0,486
2023,6,"SKYWELL",480,0,0,0,480
2023,6,"NISSAN",0,476,0,0,476
2023,6,"HONDA",0,385,0,0,385
2023,6,"GENESIS",369,0,0,0,369
2023,6,"AIWAYS",368,0,0,0,368
2023,6,"LEAPMOTOR",320,0,0,0,320
2023,6,"AUDI",265,2,37,0,304
2023,6,"VOLKSWAGEN",302,0,0,0,302
2023,6,"WEY",0,0,276,0,276
2023,6,"LYNKCO",0,0,230,0,230
2023,6,"FIAT",207,0,0,0,207
2023,6,"MAXUS",181,0,0,0,181
2023,6,"RENAULT",0,127,0,0,127
2023,6,"CITROEN",117,0,0,0,117
2023,6,"VOYAH",100,0,0,0,100
2023,6,"JAC",96,0,0,0,96
2023,6,"POLESTAR",88,0,0,0,88
2023,6,"PEUGEOT",45,0,40,0,85
2023,6,"EVEASY",81,0,0,0,81
2023,6,"HONGQI",79,0,0,0,79
2023,6,"MITSUBISHI",0,0,61,0,61
2023,6,"DS_AUTOMOBILES",7,0,43,0,50
2023,6,"MINI",9,0,40,0,49
2023,6,"OPEL",45,0,0,0,45
2023,6,"PORSCHE",22,0,9,0,31
2023,6,"LEVC",22,0,0,0,22
2023,6,"CUPRA",0,0,21,0,21
2023,6,"LAND_ROVER",0,0,20,0,20
2023,6,"FORTHING",8,0,0,0,8
2023,6,"FERRARI",0,0,7,0,7
2023,6,"WELTMEISTER",3,0,0,0,3
2023,6,"CHERY",2,0,0,0,2
2023,6,"JAGUAR",0,0,1,0,1
2023,6,"DACIA",0,0,0,0,0
2023,6,"ASTON_MARTIN",0,0,0,0,0
2023,6,"MAZDA",0,0,0,0,0
2023,6,"FORD",0,0,0,0,0
2023,6,"BENTLEY",0,0,0,0,0
2023,6,"ALFA_ROMEO",0,0,0,0,0
2023,6,"INFINITI",0,0,0,0,0
2023,6,"ABARTH",0,0,0,0,0
2023,6,"MAN",0,0,0,0,0
2023,6,"SEAT",0,0,0,0,0
2023,6,"CADILLAC",0,0,0,0,0
2023,6,"CHEVROLET",0,0,0,0,0
2023,6,"ISUZU",0,0,0,0,0
2023,6,"JEEP",0,0,0,0,0
2023,6,"MASERATI",0,0,0,0,0
2023,6,"SUBARU",0,0,0,0,0
2023,6,"SSANGYONG",0,0,0,0,0
2023,7,"TOYOTA",636,14669,188,0,15493
2023,7,"HYUNDAI",3523,7690,0,0,11213
2023,7,"BYDAUTO",10931,0,0,0,10931
2023,7,"KIA",716,380,5936,0,7032
2023,7,"SUZUKI",0,5761,0,0,5761
2023,7,"GEELY",4847,0,0,0,4847
2023,7,"TESLA",3301,0,0,0,3301
2023,7,"MG",1036,0,2230,0,3266
2023,7,"MERCEDES_BENZ",819,0,573,77,1469
2023,7,"SKODA",1141,0,52,0,1193
2023,7,"LEXUS",28,706,321,0,1055
2023,7,"BMW",190,0,606,0,796
2023,7,"VOLVO",258,0,408,0,666
2023,7,"SERES",592,0,0,0,592
2023,7,"ORA",567,0,0,0,567
2023,7,"NISSAN",0,552,0,0,552
2023,7,"SKYWELL",499,0,0,0,499
2023,7,"HONDA",0,455,0,0,455
2023,7,"GENESIS",414,0,0,0,414
2023,7,"AIWAYS",368,0,0,0,368
2023,7,"VOLKSWAGEN",361,0,0,0,361
2023,7,"LEAPMOTOR",357,0,0,0,357
2023,7,"AUDI",293,2,40,0,335
2023,7,"WEY",0,0,309,0,309
2023,7,"LYNKCO",0,0,263,0,263
2023,7,"FIAT",252,0,0,0,252
2023,7,"MAXUS",199,0,0,0,199
2023,7,"RENAULT",0,151,0,0,151
2023,7,"CITROEN",147,0,0,0,147
2023,7,"POLESTAR",144,0,0,0,144
2023,7,"JAC",115,0,0,0,115
2023,7,"VOYAH",109,0,0,0,109
2023,7,"EVEASY",104,0,0,0,104
2023,7,"PEUGEOT",59,0,42,0,101
2023,7,"MITSUBISHI",0,0,85,0,85
2023,7,"HONGQI",80,0,0,0,80
2023,7,"MINI",10,0,44,0,54
2023,7,"DS_AUTOMOBILES",7,0,46,0,53
2023,7,"OPEL",48,0,0,0,48
2023,7,"PORSCHE",25,0,10,0,35
2023,7,"CUPRA",0,0,29,0,29
2023,7,"LAND_ROVER",0,0,25,0,25
2023,7,"LEVC",22,0,0,0,22
2023,7,"FORTHING",8,0,0,0,8
2023,7,"FERRARI",0,0,7,0,7
2023,7,"WELTMEISTER",3,0,0,0,3
2023,7,"JAGUAR",1,0,1,0,2
2023,7,"CHERY",2,0,0,0,2
2023,7,"FORD",0,1,0,0,1
2023,7,"ABARTH",0,0,0,0,0
2023,7,"ASTON_MARTIN",0,0,0,0,0
2023,7,"BENTLEY",0,0,0,0,0
2023,7,"JEEP",0,0,0,0,0
2023,7,"MASERATI",0,0,0,0,0
2023,7,"SUBARU",0,0,0,0,0
2023,7,"MAZDA",0,0,0,0,0
2023,7,"SSANGYONG",0,0,0,0,0
2023,7,"MAN",0,0,0,0,0
2023,7,"CADILLAC",0,0,0,0,0
2023,7,"CHEVROLET",0,0,0,0,0
2023,7,"ISUZU",0,0,0,0,0
2023,7,"INFINITI",0,0,0,0,0
2023,7,"ALFA_ROMEO",0,0,0,0,0
2023,7,"SEAT",0,0,0,0,0
2023,7,"DACIA",0,0,0,0,0
2023,7,"ALPINE",0,0,0,0,0
2023,8,"TOYOTA",744,17026,215,0,17985
2023,8,"HYUNDAI",3879,8547,0,0,12426
2023,8,"BYDAUTO",12169,0,0,0,12169
2023,8,"KIA",767,454,6904,0,8125
2023,8,"SUZUKI",0,6560,0,0,6560
2023,8,"GEELY",5581,0,0,0,5581
2023,8,"TESLA",4948,0,0,0,4948
2023,8,"MG",1411,0,2415,0,3826
2023,8,"MERCEDES_BENZ",852,0,600,84,1536
2023,8,"SKODA",1333,0,55,0,1388
2023,8,"LEXUS",36,834,341,0,1211
2023,8,"BMW",209,0,651,0,860
2023,8,"VOLVO",260,0,453,0,713
2023,8,"ORA",710,0,0,0,710
2023,8,"NISSAN",0,641,0,0,641
2023,8,"SERES",629,0,0,0,629
2023,8,"SKYWELL",541,0,0,0,541
2023,8,"HONDA",0,489,0,0,489
2023,8,"GENESIS",459,0,0,0,459
2023,8,"VOLKSWAGEN",412,0,0,0,412
2023,8,"LEAPMOTOR",408,0,0,0,408
2023,8,"AUDI",344,2,53,0,399
2023,8,"AIWAYS",369,0,0,0,369
2023,8,"WEY",0,0,337,0,337
2023,8,"LYNKCO",0,0,335,0,335
2023,8,"FIAT",308,0,0,0,308
2023,8,"MAXUS",225,0,0,0,225
2023,8,"POLESTAR",193,0,0,0,193
2023,8,"EVEASY",179,0,0,0,179
2023,8,"RENAULT",0,173,0,0,173
2023,8,"CITROEN",165,0,0,0,165
2023,8,"JAC",140,0,0,0,140
2023,8,"VOYAH",118,0,0,0,118
2023,8,"PEUGEOT",71,0,43,0,114
2023,8,"MITSUBISHI",0,0,102,0,102
2023,8,"HONGQI",80,0,0,0,80
2023,8,"MINI",11,0,47,0,58
2023,8,"DS_AUTOMOBILES",7,0,51,0,58
2023,8,"OPEL",51,0,0,0,51
2023,8,"CUPRA",0,0,36,0,36
2023,8,"PORSCHE",26,0,10,0,36
2023,8,"LAND_ROVER",0,0,29,0,29
2023,8,"LEVC",22,0,0,0,22
2023,8,"FERRARI",0,0,8,0,8
2023,8,"FORTHING",8,0,0,0,8
2023,8,"WELTMEISTER",4,0,0,0,4
2023,8,"JAGUAR",1,0,1,0,2
2023,8,"CHERY",2,0,0,0,2
2023,8,"DACIA",0,1,0,0,1
2023,8,"FORD",0,1,0,0,1
2023,8,"JEEP",0,0,0,0,0
2023,8,"BENTLEY",0,0,0,0,0
2023,8,"MASERATI",0,0,0,0,0
2023,8,"SUBARU",0,0,0,0,0
2023,8,"INFINITI",0,0,0,0,0
2023,8,"ALFA_ROMEO",0,0,0,0,0
2023,8,"SSANGYONG",0,0,0,0,0
2023,8,"MAN",0,0,0,0,0
2023,8,"CADILLAC",0,0,0,0,0
2023,8,"CHEVROLET",0,0,0,0,0
2023,8,"ISUZU",0,0,0,0,0
2023,8,"SEAT",0,0,0,0,0
2023,8,"ASTON_MARTIN",0,0,0,0,0
2023,8,"ABARTH",0,0,0,0,0
2023,8,"MAZDA",0,0,0,0,0
2023,8,"ALPINE",0,0,0,0,0
2023,9,"TOYOTA",821,19225,225,0,20271
2023,9,"BYDAUTO",13481,0,0,0,13481
2023,9,"HYUNDAI",4099,9168,0,0,13267
2023,9,"KIA",812,496,7632,0,8940
2023,9,"SUZUKI",0,7220,0,0,7220
2023,9,"GEELY",6180,0,0,0,6180
2023,9,"TESLA",5463,0,0,0,5463
2023,9,"MG",1858,0,2576,0,4434
2023,9,"MERCEDES_BENZ",877,0,632,87,1596
2023,9,"SKODA",1427,0,58,0,1485
2023,9,"LEXUS",40,890,348,0,1278
2023,9,"BMW",230,0,704,0,934
2023,9,"ORA",791,0,0,0,791
2023,9,"VOLVO",265,0,482,0,747
2023,9,"NISSAN",0,703,0,0,703
2023,9,"SERES",681,0,0,0,681
2023,9,"SKYWELL",569,0,0,0,569
2023,9,"HONDA",0,511,0,0,511
2023,9,"GENESIS",510,0,0,0,510
2023,9,"VOLKSWAGEN",445,0,0,0,445
2023,9,"AUDI",366,2,59,0,427
2023,9,"LEAPMOTOR",424,0,0,0,424
2023,9,"WEY",0,0,376,0,376
2023,9,"FIAT",373,0,0,0,373
2023,9,"AIWAYS",369,0,0,0,369
2023,9,"LYNKCO",0,0,363,0,363
2023,9,"EVEASY",344,0,0,0,344
2023,9,"MAXUS",243,0,0,0,243
2023,9,"POLESTAR",224,0,0,0,224
2023,9,"RENAULT",0,211,0,0,211
2023,9,"CITROEN",184,0,0,0,184
2023,9,"JAC",146,0,0,0,146
2023,9,"VOYAH",130,0,0,0,130
2023,9,"PEUGEOT",78,0,45,0,123
2023,9,"MITSUBISHI",0,0,117,0,117
2023,9,"HONGQI",80,0,0,0,80
2023,9,"DS_AUTOMOBILES",10,0,54,0,64
2023,9,"MINI",11,0,50,0,61
2023,9,"OPEL",52,0,0,0,52
2023,9,"CUPRA",0,0,45,0,45
2023,9,"PORSCHE",27,0,10,0,37
2023,9,"LAND_ROVER",0,0,30,0,30
2023,9,"LEVC",22,0,0,0,22
2023,9,"FERRARI",0,0,8,0,8
2023,9,"FORTHING",8,0,0,0,8
2023,9,"DACIA",0,5,0,0,5
2023,9,"WELTMEISTER",4,0,0,0,4
2023,9,"JAGUAR",1,0,1,0,2
2023,9,"CHERY",2,0,0,0,2
2023,9,"FORD",0,1,0,0,1
2023,9,"JEEP",0,0,0,0,0
2023,9,"BENTLEY",0,0,0,0,0
2023,9,"MASERATI",0,0,0,0,0
2023,9,"SUBARU",0,0,0,0,0
2023,9,"INFINITI",0,0,0,0,0
2023,9,"ALFA_ROMEO",0,0,0,0,0
2023,9,"SSANGYONG",0,0,0,0,0
2023,9,"MAN",0,0,0,0,0
2023,9,"CADILLAC",0,0,0,0,0
2023,9,"CHEVROLET",0,0,0,0,0
2023,9,"ISUZU",0,0,0,0,0
2023,9,"SEAT",0,0,0,0,0
2023,9,"ABARTH",0,0,0,0,0
2023,9,"ASTON_MARTIN",0,0,0,0,0
2023,9,"MAZDA",0,0,0,0,0
2023,9,"ALPINE",0,0,0,0,0
2023,10,"TOYOTA",877,20689,233,0,21799
2023,10,"BYDAUTO",14321,0,0,0,14321
2023,10,"HYUNDAI",4252,9967,0,0,14219
2023,10,"KIA",848,533,8095,0,9476
2023,10,"SUZUKI",0,7631,0,0,7631
2023,10,"GEELY",6480,0,0,0,6480
2023,10,"TESLA",5584,0,0,0,5584
2023,10,"MG",2267,0,2626,0,4893
2023,10,"MERCEDES_BENZ",886,0,641,88,1615
2023,10,"SKODA",1513,0,62,0,1575
2023,10,"LEXUS",46,944,366,0,1356
2023,10,"BMW",240,0,714,0,954
2023,10,"ORA",878,0,0,0,878
2023,10,"VOLVO",280,0,505,0,785
2023,10,"SERES",773,0,0,0,773
2023,10,"NISSAN",0,746,0,0,746
2023,10,"SKYWELL",582,0,0,0,582
2023,10,"HONDA",0,528,0,0,528
2023,10,"GENESIS",526,0,0,0,526
2023,10,"VOLKSWAGEN",471,0,0,0,471
2023,10,"AUDI",378,2,62,0,442
2023,10,"LEAPMOTOR",438,0,0,0,438
2023,10,"WEY",0,0,392,0,392
2023,10,"FIAT",382,0,0,0,382
2023,10,"LYNKCO",0,0,381,0,381
2023,10,"EVEASY",371,0,0,0,371
2023,10,"AIWAYS",369,0,0,0,369
2023,10,"MAXUS",245,0,0,0,245
2023,10,"RENAULT",0,236,0,0,236
2023,10,"POLESTAR",228,0,0,0,228
2023,10,"CITROEN",192,0,0,0,192
2023,10,"JAC",158,0,0,0,158
2023,10,"VOYAH",139,0,0,0,139
2023,10,"PEUGEOT",85,0,46,0,131
2023,10,"MITSUBISHI",0,0,122,0,122
2023,10,"HONGQI",80,0,0,0,80
2023,10,"DS_AUTOMOBILES",10,0,58,0,68
2023,10,"MINI",13,0,54,0,67
2023,10,"OPEL",54,0,0,0,54
2023,10,"CUPRA",0,0,50,0,50
2023,10,"PORSCHE",29,0,11,0,40
2023,10,"LAND_ROVER",0,0,34,0,34
2023,10,"LEVC",22,0,0,0,22
2023,10,"XPENG",16,0,0,0,16
2023,10,"FORTHING",8,0,0,0,8
2023,10,"FERRARI",0,0,8,0,8
2023,10,"DACIA",0,7,0,0,7
2023,10,"WELTMEISTER",4,0,0,0,4
2023,10,"JAGUAR",1,0,2,0,3
2023,10,"CHERY",2,0,0,0,2
2023,10,"FORD",0,1,0,0,1
2023,10,"ALPINE",0,0,0,0,0
2023,10,"ASTON_MARTIN",0,0,0,0,0
2023,10,"BENTLEY",0,0,0,0,0
2023,10,"CADILLAC",0,0,0,0,0
2023,10,"ISUZU",0,0,0,0,0
2023,10,"INFINITI",0,0,0,0,0
2023,10,"MAZDA",0,0,0,0,0
2023,10,"SEAT",0,0,0,0,0
2023,10,"ABARTH",0,0,0,0,0
2023,10,"SSANGYONG",0,0,0,0,0
2023,10,"SUBARU",0,0,0,0,0
2023,10,"MASERATI",0,0,0,0,0
2023,10,"MAN",0,0,0,0,0
2023,10,"JEEP",0,0,0,0,0
2023,10,"CHEVROLET",0,0,0,0,0
2023,10,"ALFA_ROMEO",0,0,0,0,0
2023,11,"TOYOTA",926,22783,234,0,23943
2023,11,"HYUNDAI",4408,10574,0,0,14982
2023,11,"BYDAUTO",14948,0,0,0,14948
2023,11,"KIA",885,578,8396,0,9859
2023,11,"SUZUKI",0,8094,0,0,8094
2023,11,"GEELY",6884,0,0,0,6884
2023,11,"TESLA",6334,0,0,0,6334
2023,11,"MG",2559,0,2642,0,5201
2023,11,"SKODA",1698,0,67,0,1765
2023,11,"MERCEDES_BENZ",891,0,644,88,1623
2023,11,"LEXUS",52,1000,397,0,1449
2023,11,"BMW",248,0,726,0,974
2023,11,"ORA",927,0,0,0,927
2023,11,"SERES",840,0,0,0,840
2023,11,"VOLVO",294,0,535,0,829
2023,11,"NISSAN",0,771,0,0,771
2023,11,"SKYWELL",602,0,0,0,602
2023,11,"HONDA",0,554,0,0,554
2023,11,"GENESIS",534,0,0,0,534
2023,11,"VOLKSWAGEN",493,0,0,0,493
2023,11,"AUDI",383,2,65,0,450
2023,11,"LEAPMOTOR",449,0,0,0,449
2023,11,"WEY",0,0,414,0,414
2023,11,"FIAT",397,0,0,0,397
2023,11,"LYNKCO",0,0,395,0,395
2023,11,"EVEASY",387,0,0,0,387
2023,11,"AIWAYS",369,0,0,0,369
2023,11,"MAXUS",260,0,0,0,260
2023,11,"RENAULT",0,242,0,0,242
2023,11,"POLESTAR",236,0,0,0,236
2023,11,"CITROEN",204,0,0,0,204
2023,11,"JAC",160,0,0,0,160
2023,11,"VOYAH",140,0,0,0,140
2023,11,"PEUGEOT",89,0,48,0,137
2023,11,"MITSUBISHI",0,0,132,0,132
2023,11,"HONGQI",84,0,0,0,84
2023,11,"DS_AUTOMOBILES",10,0,59,0,69
2023,11,"MINI",13,0,56,0,69
2023,11,"CUPRA",0,0,60,0,60
2023,11,"OPEL",56,0,0,0,56
2023,11,"LAND_ROVER",0,0,41,0,41
2023,11,"PORSCHE",29,0,11,0,40
2023,11,"XPENG",23,0,0,0,23
2023,11,"LEVC",22,0,0,0,22
2023,11,"FORTHING",8,0,0,0,8
2023,11,"FERRARI",0,0,8,0,8
2023,11,"DACIA",0,7,0,0,7
2023,11,"SMART",5,0,0,0,5
2023,11,"WELTMEISTER",4,0,0,0,4
2023,11,"JAGUAR",1,0,2,0,3
2023,11,"CHERY",2,0,0,0,2
2023,11,"FORD",0,1,0,0,1
2023,11,"MAN",0,0,0,0,0
2023,11,"MASERATI",0,0,0,0,0
2023,11,"MAZDA",0,0,0,0,0
2023,11,"JEEP",0,0,0,0,0
2023,11,"ISUZU",0,0,0,0,0
2023,11,"INFINITI",0,0,0,0,0
2023,11,"SEAT",0,0,0,0,0
2023,11,"CHEVROLET",0,0,0,0,0
2023,11,"SSANGYONG",0,0,0,0,0
2023,11,"SUBARU",0,0,0,0,0
2023,11,"CADILLAC",0,0,0,0,0
2023,11,"ABARTH",0,0,0,0,0
2023,11,"BENTLEY",0,0,0,0,0
2023,11,"ASTON_MARTIN",0,0,0,0,0
2023,11,"ALPINE",0,0,0,0,0
2023,11,"ALFA_ROMEO",0,0,0,0,0
2023,12,"TOYOTA",965,23761,235,0,24961
2023,12,"BYDAUTO",15145,0,0,0,15145
2023,12,"HYUNDAI",4424,10622,0,0,15046
2023,12,"KIA",893,618,8454,0,9965
2023,12,"SUZUKI",0,8285,0,0,8285
2023,12,"GEELY",7129,0,0,0,7129
2023,12,"TESLA",6767,0,0,0,6767
2023,12,"MG",2760,0,2661,0,5421
2023,12,"SKODA",1725,0,67,0,1792
2023,12,"MERCEDES_BENZ",892,0,645,88,1625
2023,12,"LEXUS",70,1057,420,0,1547
2023,12,"BMW",249,0,727,0,976
2023,12,"ORA",932,0,0,0,932
2023,12,"SERES",871,0,0,0,871
2023,12,"VOLVO",300,0,546,0,846
2023,12,"NISSAN",0,801,0,0,801
2023,12,"SKYWELL",619,0,0,0,619
2023,12,"HONDA",0,564,0,0,564
2023,12,"GENESIS",535,0,0,0,535
2023,12,"VOLKSWAGEN",512,0,0,0,512
2023,12,"LEAPMOTOR",459,0,0,0,459
2023,12,"AUDI",383,2,65,0,450
2023,12,"WEY",0,0,422,0,422
2023,12,"EVEASY",408,0,0,0,408
2023,12,"LYNKCO",0,0,404,0,404
2023,12,"FIAT",400,0,0,0,400
2023,12,"AIWAYS",369,0,0,0,369
2023,12,"MAXUS",272,0,0,0,272
2023,12,"RENAULT",0,254,0,0,254
2023,12,"POLESTAR",251,0,0,0,251
2023,12,"CITROEN",211,0,0,0,211
2023,12,"JAC",170,0,0,0,170
2023,12,"VOYAH",142,0,0,0,142
2023,12,"PEUGEOT",91,0,49,0,140
2023,12,"MITSUBISHI",0,0,133,0,133
2023,12,"HONGQI",84,0,0,0,84
2023,12,"DS_AUTOMOBILES",10,0,59,0,69
2023,12,"MINI",13,0,56,0,69
2023,12,"CUPRA",0,0,60,0,60
2023,12,"OPEL",58,0,0,0,58
2023,12,"LAND_ROVER",0,0,45,0,45
2023,12,"PORSCHE",32,0,11,0,43
2023,12,"XPENG",23,0,0,0,23
2023,12,"LEVC",22,0,0,0,22
2023,12,"SMART",13,0,0,0,13
2023,12,"FORTHING",9,0,0,0,9
2023,12,"FERRARI",0,0,8,0,8
2023,12,"DACIA",0,7,0,0,7
2023,12,"WELTMEISTER",5,0,0,0,5
2023,12,"JAGUAR",1,0,2,0,3
2023,12,"ZEEKR",3,0,0,0,3
2023,12,"CHERY",2,0,0,0,2
2023,12,"FORD",0,1,0,0,1
2023,12,"ALPINE",0,0,0,0,0
2023,12,"MAN",0,0,0,0,0
2023,12,"ASTON_MARTIN",0,0,0,0,0
2023,12,"MAZDA",0,0,0,0,0
2023,12,"ALFA_ROMEO",0,0,0,0,0
2023,12,"ISUZU",0,0,0,0,0
2023,12,"ABARTH",0,0,0,0,0
2023,12,"CHEVROLET",0,0,0,0,0
2023,12,"CADILLAC",0,0,0,0,0
2023,12,"SEAT",0,0,0,0,0
2023,12,"SSANGYONG",0,0,0,0,0
2023,12,"INFINITI",0,0,0,0,0
2023,12,"JEEP",0,0,0,0,0
2023,12,"BENTLEY",0,0,0,0,0
2023,12,"MASERATI",0,0,0,0,0
2023,12,"SUBARU",0,0,0,0,0
2024,1,"BYDAUTO",3331,0,0,0,3331
2024,1,"TOYOTA",162,2229,2,0,2393
2024,1,"HYUNDAI",572,1749,0,0,2321
2024,1,"KIA",232,123,978,0,1333
2024,1,"SUZUKI",0,1317,0,0,1317
2024,1,"GEELY",1078,0,0,0,1078
2024,1,"MG",704,0,165,0,869
2024,1,"SERES",406,0,0,0,406
2024,1,"XPENG",301,0,0,0,301
2024,1,"SMART",263,0,0,0,263
2024,1,"LEXUS",28,153,76,0,257
2024,1,"ORA",252,0,0,0,252
2024,1,"BMW",85,0,164,0,249
2024,1,"SKODA",220,0,9,0,229
2024,1,"MERCEDES_BENZ",118,0,94,0,212
2024,1,"EVEASY",203,0,0,0,203
2024,1,"NISSAN",0,166,0,0,166
2024,1,"LYNKCO",0,0,145,0,145
2024,1,"POLESTAR",132,0,0,0,132
2024,1,"VOLVO",46,0,81,0,127
2024,1,"GENESIS",116,0,0,0,116
2024,1,"WEY",0,0,115,0,115
2024,1,"SKYWELL",95,0,0,0,95
2024,1,"HONDA",0,79,0,0,79
2024,1,"CUPRA",0,0,67,0,67
2024,1,"VOYAH",66,0,0,0,66
2024,1,"AUDI",29,0,25,0,54
2024,1,"MITSUBISHI",0,0,47,0,47
2024,1,"MAXUS",46,0,0,0,46
2024,1,"VOLKSWAGEN",32,0,0,0,32
2024,1,"FIAT",30,0,0,0,30
2024,1,"RENAULT",0,29,0,0,29
2024,1,"CITROEN",28,0,0,0,28
2024,1,"CHERY",20,0,0,0,20
2024,1,"ZEEKR",20,0,0,0,20
2024,1,"LAND_ROVER",0,0,18,0,18
2024,1,"MINI",3,0,13,0,16
2024,1,"LEAPMOTOR",14,0,0,0,14
2024,1,"JEEP",14,0,0,0,14
2024,1,"JAC",13,0,0,0,13
2024,1,"DS_AUTOMOBILES",0,0,13,0,13
2024,1,"PORSCHE",9,0,2,0,11
2024,1,"TESLA",7,0,0,0,7
2024,1,"OPEL",7,0,0,0,7
2024,1,"PEUGEOT",4,0,3,0,7
2024,1,"HONGQI",6,0,0,0,6
2024,1,"DACIA",0,1,0,0,1
2024,1,"FERRARI",0,0,1,0,1
2024,1,"ABARTH",1,0,0,0,1
2024,1,"SEAT",0,0,0,0,0
2024,1,"ISUZU",0,0,0,0,0
2024,1,"CHEVROLET",0,0,0,0,0
2024,1,"CADILLAC",0,0,0,0,0
2024,1,"INFINITI",0,0,0,0,0
2024,1,"BENTLEY",0,0,0,0,0
2024,1,"SSANGYONG",0,0,0,0,0
2024,1,"ALPINE",0,0,0,0,0
2024,1,"FORD",0,0,0,0,0
2024,1,"MAZDA",0,0,0,0,0
2024,1,"MAN",0,0,0,0,0
2024,1,"SUBARU",0,0,0,0,0
2024,1,"MASERATI",0,0,0,0,0
2024,1,"ALFA_ROMEO",0,0,0,0,0
2024,2,"BYDAUTO",5290,0,0,0,5290
2024,2,"TOYOTA",307,4118,2,0,4427
2024,2,"HYUNDAI",820,2641,0,0,3461
2024,2,"KIA",504,175,1487,0,2166
2024,2,"SUZUKI",0,1881,0,0,1881
2024,2,"GEELY",1626,0,0,0,1626
2024,2,"MG",1376,0,166,0,1542
2024,2,"SERES",641,0,0,0,641
2024,2,"ORA",532,0,0,0,532
2024,2,"XPENG",532,0,0,0,532
2024,2,"LEXUS",41,229,115,0,385
2024,2,"ZEEKR",383,0,0,0,383
2024,2,"MERCEDES_BENZ",229,0,141,1,371
2024,2,"SKODA",341,0,15,0,356
2024,2,"TESLA",356,0,0,0,356
2024,2,"NISSAN",0,354,0,0,354
2024,2,"CHERY",342,0,0,0,342
2024,2,"BMW",127,0,215,0,342
2024,2,"SMART",272,0,0,0,272
2024,2,"SKYWELL",247,0,0,0,247
2024,2,"LYNKCO",0,0,238,0,238
2024,2,"VOLVO",100,0,116,0,216
2024,2,"EVEASY",209,0,0,0,209
2024,2,"AUDI",123,0,47,0,170
2024,2,"GENESIS",169,0,0,0,169
2024,2,"WEY",0,0,163,0,163
2024,2,"POLESTAR",154,0,0,0,154
2024,2,"RENAULT",0,114,0,0,114
2024,2,"CUPRA",0,0,110,0,110
2024,2,"VOYAH",106,0,0,0,106
2024,2,"JAC",103,0,0,0,103
2024,2,"HONDA",0,101,0,0,101
2024,2,"MAXUS",79,0,0,0,79
2024,2,"VOLKSWAGEN",66,0,0,0,66
2024,2,"MITSUBISHI",0,0,58,0,58
2024,2,"CITROEN",45,0,0,0,45
2024,2,"FIAT",42,0,0,0,42
2024,2,"LAND_ROVER",0,0,33,0,33
2024,2,"LEAPMOTOR",31,0,0,0,31
2024,2,"JEEP",26,0,0,0,26
2024,2,"MINI",3,0,18,0,21
2024,2,"PEUGEOT",10,0,9,0,19
2024,2,"DS_AUTOMOBILES",1,0,17,0,18
2024,2,"OPEL",13,0,0,0,13
2024,2,"FORTHING",12,0,0,0,12
2024,2,"PORSCHE",10,0,2,0,12
2024,2,"HONGQI",11,0,0,0,11
2024,2,"AIWAYS",7,0,0,0,7
2024,2,"DACIA",0,3,0,0,3
2024,2,"WELTMEISTER",2,0,0,0,2
2024,2,"FERRARI",0,0,2,0,2
2024,2,"ABARTH",1,0,0,0,1
2024,2,"SEAT",0,0,0,0,0
2024,2,"MAN",0,0,0,0,0
2024,2,"ISUZU",0,0,0,0,0
2024,2,"ASTON_MARTIN",0,0,0,0,0
2024,2,"CHEVROLET",0,0,0,0,0
2024,2,"CADILLAC",0,0,0,0,0
2024,2,"SSANGYONG",0,0,0,0,0
2024,2,"JAGUAR",0,0,0,0,0
2024,2,"ALPINE",0,0,0,0,0
2024,2,"BENTLEY",0,0,0,0,0
2024,2,"FORD",0,0,0,0,0
2024,2,"MAZDA",0,0,0,0,0
2024,2,"SUBARU",0,0,0,0,0
2024,2,"MASERATI",0,0,0,0,0
2024,2,"INFINITI",0,0,0,0,0
2024,2,"ALFA_ROMEO",0,0,0,0,0
2024,3,"BYDAUTO",6995,0,0,0,6995
2024,3,"TOYOTA",464,5993,2,0,6459
2024,3,"HYUNDAI",954,4146,0,0,5100
2024,3,"SUZUKI",0,2714,0,0,2714
2024,3,"KIA",924,211,1532,0,2667
2024,3,"MG",1792,0,166,0,1958
2024,3,"GEELY",1932,0,0,0,1932
2024,3,"TESLA",1774,0,0,0,1774
2024,3,"CHERY",997,0,0,0,997
2024,3,"XPENG",793,0,0,0,793
2024,3,"SERES",764,0,0,0,764
2024,3,"ZEEKR",729,0,0,0,729
2024,3,"ORA",661,0,0,0,661
2024,3,"MERCEDES_BENZ",323,0,272,4,599
2024,3,"NISSAN",0,580,0,0,580
2024,3,"LEXUS",60,349,170,0,579
2024,3,"SKODA",456,0,23,0,479
2024,3,"BMW",184,0,292,0,476
2024,3,"SMART",402,0,0,0,402
2024,3,"VOLVO",130,0,153,0,283
2024,3,"SKYWELL",270,0,0,0,270
2024,3,"AUDI",195,0,65,0,260
2024,3,"LYNKCO",0,0,249,0,249
2024,3,"GENESIS",243,0,0,0,243
2024,3,"EVEASY",219,0,0,0,219
2024,3,"WEY",0,0,216,0,216
2024,3,"POLESTAR",200,0,0,0,200
2024,3,"RENAULT",0,162,0,0,162
2024,3,"VOLKSWAGEN",155,0,0,0,155
2024,3,"CUPRA",0,0,138,0,138
2024,3,"JAC",138,0,0,0,138
2024,3,"FIAT",127,0,0,0,127
2024,3,"VOYAH",121,0,0,0,121
2024,3,"HONDA",0,113,0,0,113
2024,3,"MAXUS",95,0,0,0,95
2024,3,"FORTHING",75,0,0,0,75
2024,3,"MITSUBISHI",0,0,70,0,70
2024,3,"CITROEN",64,0,0,0,64
2024,3,"LEAPMOTOR",50,0,0,0,50
2024,3,"DS_AUTOMOBILES",2,0,42,0,44
2024,3,"LAND_ROVER",0,0,41,0,41
2024,3,"JEEP",30,0,0,0,30
2024,3,"MINI",3,0,26,0,29
2024,3,"OPEL",28,0,0,0,28
2024,3,"PEUGEOT",10,0,17,0,27
2024,3,"HONGQI",17,0,0,0,17
2024,3,"PORSCHE",11,0,4,0,15
2024,3,"DACIA",0,8,0,0,8
2024,3,"AIWAYS",7,0,0,0,7
2024,3,"FERRARI",0,0,3,0,3
2024,3,"WELTMEISTER",2,0,0,0,2
2024,3,"ABARTH",2,0,0,0,2
2024,3,"ISUZU",0,0,0,0,0
2024,3,"SEAT",0,0,0,0,0
2024,3,"ASTON_MARTIN",0,0,0,0,0
2024,3,"CHEVROLET",0,0,0,0,0
2024,3,"ALFA_ROMEO",0,0,0,0,0
2024,3,"CADILLAC",0,0,0,0,0
2024,3,"MAN",0,0,0,0,0
2024,3,"SSANGYONG",0,0,0,0,0
2024,3,"JAGUAR",0,0,0,0,0
2024,3,"ALPINE",0,0,0,0,0
2024,3,"BENTLEY",0,0,0,0,0
2024,3,"FORD",0,0,0,0,0
2024,3,"MAZDA",0,0,0,0,0
2024,3,"SUBARU",0,0,0,0,0
2024,3,"MASERATI",0,0,0,0,0
2024,3,"INFINITI",0,0,0,0,0
2024,4,"TOYOTA",586,8029,2,0,8617
2024,4,"BYDAUTO",7873,0,0,0,7873
2024,4,"HYUNDAI",1094,4887,0,0,5981
2024,4,"KIA",1376,236,1698,0,3310
2024,4,"SUZUKI",0,3232,0,0,3232
2024,4,"MG",2756,0,166,0,2922
2024,4,"GEELY",2182,0,0,0,2182
2024,4,"TESLA",1775,0,0,0,1775
2024,4,"CHERY",1209,0,0,0,1209
2024,4,"SERES",989,0,0,0,989
2024,4,"XPENG",936,0,0,0,936
2024,4,"ZEEKR",928,0,0,0,928
2024,4,"LEXUS",67,542,213,0,822
2024,4,"ORA",759,0,0,0,759
2024,4,"MERCEDES_BENZ",360,0,291,4,655
2024,4,"NISSAN",0,643,0,0,643
2024,4,"BMW",242,0,343,0,585
2024,4,"SKODA",519,0,26,0,545
2024,4,"SMART",484,0,0,0,484
2024,4,"GENESIS",379,0,0,0,379
2024,4,"SKYWELL",378,0,0,0,378
2024,4,"VOLVO",177,0,169,0,346
2024,4,"AUDI",261,0,78,0,339
2024,4,"LYNKCO",0,0,268,0,268
2024,4,"WEY",0,0,246,0,246
2024,4,"EVEASY",231,0,0,0,231
2024,4,"RENAULT",0,208,0,0,208
2024,4,"POLESTAR",200,0,0,0,200
2024,4,"VOLKSWAGEN",194,0,0,0,194
2024,4,"FORTHING",191,0,0,0,191
2024,4,"CUPRA",0,0,171,0,171
2024,4,"JAC",138,0,0,0,138
2024,4,"VOYAH",132,0,0,0,132
2024,4,"CITROEN",127,0,0,0,127
2024,4,"FIAT",127,0,0,0,127
2024,4,"MAXUS",120,0,0,0,120
2024,4,"HONDA",0,118,0,0,118
2024,4,"MITSUBISHI",0,0,73,0,73
2024,4,"LEAPMOTOR",65,0,0,0,65
2024,4,"DS_AUTOMOBILES",3,0,60,0,63
2024,4,"LAND_ROVER",0,0,47,0,47
2024,4,"MINI",5,0,33,0,38
2024,4,"OPEL",34,0,0,0,34
2024,4,"JEEP",33,0,0,0,33
2024,4,"PEUGEOT",11,1,20,0,32
2024,4,"HONGQI",20,0,0,0,20
2024,4,"PORSCHE",13,0,6,0,19
2024,4,"DACIA",0,12,0,0,12
2024,4,"AIWAYS",7,0,0,0,7
2024,4,"FERRARI",0,0,3,0,3
2024,4,"WELTMEISTER",2,0,0,0,2
2024,4,"ABARTH",2,0,0,0,2
2024,4,"ALFA_ROMEO",0,0,0,0,0
2024,4,"BENTLEY",0,0,0,0,0
2024,4,"MASERATI",0,0,0,0,0
2024,4,"SUBARU",0,0,0,0,0
2024,4,"ASTON_MARTIN",0,0,0,0,0
2024,4,"SEAT",0,0,0,0,0
2024,4,"SSANGYONG",0,0,0,0,0
2024,4,"FORD",0,0,0,0,0
2024,4,"CADILLAC",0,0,0,0,0
2024,4,"CHEVROLET",0,0,0,0,0
2024,4,"MAN",0,0,0,0,0
2024,4,"ISUZU",0,0,0,0,0
2024,4,"INFINITI",0,0,0,0,0
2024,4,"JAGUAR",0,0,0,0,0
2024,4,"ALPINE",0,0,0,0,0
2024,4,"MAZDA",0,0,0,0,0
2024,5,"TOYOTA",812,10738,2,0,11552
2024,5,"BYDAUTO",9027,0,0,0,9027
2024,5,"HYUNDAI",1295,5506,0,0,6801
2024,5,"SUZUKI",0,4033,0,0,4033
2024,5,"KIA",1853,351,1812,0,4016
2024,5,"MG",3242,0,169,0,3411
2024,5,"GEELY",2432,0,0,0,2432
2024,5,"TESLA",2182,0,0,0,2182
2024,5,"CHERY",1385,0,0,0,1385
2024,5,"ZEEKR",1182,0,0,0,1182
2024,5,"LEXUS",77,765,252,0,1094
2024,5,"SERES",1073,0,0,0,1073
2024,5,"XPENG",1018,0,0,0,1018
2024,5,"ORA",931,0,0,0,931
2024,5,"MERCEDES_BENZ",502,0,343,5,850
2024,5,"NISSAN",0,723,0,0,723
2024,5,"BMW",277,0,395,0,672
2024,5,"SKODA",577,0,63,0,640
2024,5,"SMART",580,0,0,0,580
2024,5,"AUDI",356,0,102,0,458
2024,5,"SKYWELL",441,0,0,0,441
2024,5,"VOLVO",212,0,185,0,397
2024,5,"GENESIS",393,0,0,0,393
2024,5,"EVEASY",310,0,0,0,310
2024,5,"RENAULT",0,298,0,0,298
2024,5,"FORTHING",293,0,0,0,293
2024,5,"WEY",0,0,284,0,284
2024,5,"LYNKCO",0,0,281,0,281
2024,5,"VOLKSWAGEN",245,0,0,0,245
2024,5,"CUPRA",0,0,218,0,218
2024,5,"POLESTAR",200,0,0,0,200
2024,5,"VOYAH",147,0,0,0,147
2024,5,"CITROEN",139,0,0,0,139
2024,5,"JAC",138,0,0,0,138
2024,5,"MAXUS",130,0,0,0,130
2024,5,"FIAT",127,0,0,0,127
2024,5,"HONDA",0,123,0,0,123
2024,5,"LEAPMOTOR",87,0,0,0,87
2024,5,"MITSUBISHI",0,0,75,0,75
2024,5,"DS_AUTOMOBILES",4,0,61,0,65
2024,5,"LAND_ROVER",0,0,59,0,59
2024,5,"MINI",8,0,45,0,53
2024,5,"JEEP",42,0,0,0,42
2024,5,"OPEL",42,0,0,0,42
2024,5,"PEUGEOT",11,1,22,0,34
2024,5,"HONGQI",25,0,0,0,25
2024,5,"DACIA",0,19,0,0,19
2024,5,"PORSCHE",13,0,6,0,19
2024,5,"AIWAYS",7,0,0,0,7
2024,5,"WELTMEISTER",4,0,0,0,4
2024,5,"FERRARI",0,0,3,0,3
2024,5,"ABARTH",2,0,0,0,2
2024,5,"JAGUAR",0,0,1,0,1
2024,5,"MAZDA",0,0,0,0,0
2024,5,"MASERATI",0,0,0,0,0
2024,5,"SUBARU",0,0,0,0,0
2024,5,"FORD",0,0,0,0,0
2024,5,"SEAT",0,0,0,0,0
2024,5,"MAN",0,0,0,0,0
2024,5,"INFINITI",0,0,0,0,0
2024,5,"ALPINE",0,0,0,0,0
2024,5,"BENTLEY",0,0,0,0,0
2024,5,"SSANGYONG",0,0,0,0,0
2024,5,"ASTON_MARTIN",0,0,0,0,0
2024,5,"CADILLAC",0,0,0,0,0
2024,5,"CHEVROLET",0,0,0,0,0
2024,5,"ISUZU",0,0,0,0,0
2024,5,"ALFA_ROMEO",0,0,0,0,0
2024,5,"KGM",0,0,0,0,0
2024,6,"TOYOTA",1215,13226,2,0,14443
2024,6,"BYDAUTO",10178,0,0,0,10178
2024,6,"HYUNDAI",1529,6810,0,0,8339
2024,6,"MG",5497,0,169,0,5666
2024,6,"KIA",2066,658,1988,0,4712
2024,6,"SUZUKI",0,4699,0,0,4699
2024,6,"TESLA",3023,0,0,0,3023
2024,6,"GEELY",2682,0,0,0,2682
2024,6,"CHERY",1744,0,0,0,1744
2024,6,"ZEEKR",1459,0,0,0,1459
2024,6,"LEXUS",92,908,283,0,1283
2024,6,"XPENG",1151,0,0,0,1151
2024,6,"MERCEDES_BENZ",700,0,403,5,1108
2024,6,"SERES",1103,0,0,0,1103
2024,6,"ORA",1022,0,0,0,1022
2024,6,"NISSAN",0,784,0,0,784
2024,6,"BMW",344,0,429,0,773
2024,6,"SKODA",626,0,80,0,706
2024,6,"SMART",657,0,0,0,657
2024,6,"VOLVO",352,0,209,0,561
2024,6,"AUDI",422,1,116,0,539
2024,6,"VOLKSWAGEN",479,0,0,0,479
2024,6,"SKYWELL",456,0,0,0,456
2024,6,"GENESIS",394,0,0,0,394
2024,6,"RENAULT",1,355,0,0,356
2024,6,"FORTHING",332,0,0,0,332
2024,6,"EVEASY",314,0,0,0,314
2024,6,"WEY",0,0,312,0,312
2024,6,"LYNKCO",0,0,296,0,296
2024,6,"CUPRA",0,0,285,0,285
2024,6,"CITROEN",208,0,0,0,208
2024,6,"POLESTAR",200,0,0,0,200
2024,6,"VOYAH",176,0,0,0,176
2024,6,"LEAPMOTOR",151,0,0,0,151
2024,6,"MAXUS",145,0,0,0,145
2024,6,"JAC",138,0,0,0,138
2024,6,"HONDA",0,128,0,0,128
2024,6,"FIAT",127,0,0,0,127
2024,6,"OPEL",99,0,0,0,99
2024,6,"DS_AUTOMOBILES",5,0,79,0,84
2024,6,"MITSUBISHI",0,0,77,0,77
2024,6,"LAND_ROVER",0,0,74,0,74
2024,6,"MINI",14,0,52,0,66
2024,6,"JEEP",53,0,0,0,53
2024,6,"PEUGEOT",11,1,26,0,38
2024,6,"DACIA",0,29,0,0,29
2024,6,"HONGQI",27,0,0,0,27
2024,6,"PORSCHE",15,0,7,0,22
2024,6,"WELTMEISTER",16,0,0,0,16
2024,6,"AIWAYS",7,0,0,0,7
2024,6,"ABARTH",4,0,0,0,4
2024,6,"JAGUAR",2,0,2,0,4
2024,6,"FERRARI",0,0,4,0,4
2024,6,"FORD",0,0,0,0,0
2024,6,"MASERATI",0,0,0,0,0
2024,6,"SUBARU",0,0,0,0,0
2024,6,"SEAT",0,0,0,0,0
2024,6,"MAN",0,0,0,0,0
2024,6,"INFINITI",0,0,0,0,0
2024,6,"ALPINE",0,0,0,0,0
2024,6,"BENTLEY",0,0,0,0,0
2024,6,"SSANGYONG",0,0,0,0,0
2024,6,"ASTON_MARTIN",0,0,0,0,0
2024,6,"CADILLAC",0,0,0,0,0
2024,6,"CHEVROLET",0,0,0,0,0
2024,6,"ISUZU",0,0,0,0,0
2024,6,"MAZDA",0,0,0,0,0
2024,6,"ALFA_ROMEO",0,0,0,0,0
2024,6,"KGM",0,0,0,0,0
2024,7,"TOYOTA",1265,16905,2,0,18172
2024,7,"BYDAUTO",11871,0,0,0,11871
2024,7,"HYUNDAI",1652,8256,0,0,9908
2024,7,"MG",5715,0,169,0,5884
2024,7,"SUZUKI",0,5390,0,0,5390
2024,7,"KIA",2139,1051,2097,0,5287
2024,7,"TESLA",3211,0,0,0,3211
2024,7,"GEELY",2935,0,0,0,2935
2024,7,"CHERY",2487,0,0,0,2487
2024,7,"ZEEKR",1702,0,0,0,1702
2024,7,"LEXUS",107,1081,300,0,1488
2024,7,"XPENG",1342,0,0,0,1342
2024,7,"MERCEDES_BENZ",857,0,465,5,1327
2024,7,"SERES",1259,0,0,0,1259
2024,7,"ORA",1139,0,0,0,1139
2024,7,"NISSAN",0,838,0,0,838
2024,7,"BMW",369,0,469,0,838
2024,7,"SKODA",686,0,83,0,769
2024,7,"SMART",741,0,0,0,741
2024,7,"VOLVO",423,0,224,0,647
2024,7,"VOLKSWAGEN",646,0,0,0,646
2024,7,"AUDI",480,1,119,0,600
2024,7,"SKYWELL",513,0,0,0,513
2024,7,"RENAULT",1,450,0,0,451
2024,7,"WEY",0,0,428,0,428
2024,7,"GENESIS",395,0,0,0,395
2024,7,"FORTHING",373,0,0,0,373
2024,7,"EVEASY",343,0,0,0,343
2024,7,"LYNKCO",0,0,310,0,310
2024,7,"CUPRA",0,0,298,0,298
2024,7,"CITROEN",219,0,0,0,219
2024,7,"VOYAH",213,0,0,0,213
2024,7,"POLESTAR",200,0,0,0,200
2024,7,"LEAPMOTOR",184,0,0,0,184
2024,7,"MAXUS",173,0,0,0,173
2024,7,"HONDA",0,148,0,0,148
2024,7,"JAC",138,0,0,0,138
2024,7,"FIAT",127,0,0,0,127
2024,7,"OPEL",109,0,0,0,109
2024,7,"DS_AUTOMOBILES",5,0,90,0,95
2024,7,"MITSUBISHI",0,0,77,0,77
2024,7,"LAND_ROVER",0,0,77,0,77
2024,7,"MINI",18,0,54,0,72
2024,7,"JEEP",56,0,0,0,56
2024,7,"WELTMEISTER",48,0,0,0,48
2024,7,"DACIA",0,47,0,0,47
2024,7,"PEUGEOT",11,1,26,0,38
2024,7,"HONGQI",34,0,0,0,34
2024,7,"PORSCHE",16,0,7,0,23
2024,7,"AIWAYS",7,0,0,0,7
2024,7,"ABARTH",7,0,0,0,7
2024,7,"NETA",5,0,0,0,5
2024,7,"FERRARI",0,0,4,0,4
2024,7,"JAGUAR",2,0,2,0,4
2024,7,"ASTON_MARTIN",0,0,0,0,0
2024,7,"BENTLEY",0,0,0,0,0
2024,7,"ALFA_ROMEO",0,0,0,0,0
2024,7,"GMC",0,0,0,0,0
2024,7,"MASERATI",0,0,0,0,0
2024,7,"SEAT",0,0,0,0,0
2024,7,"SSANGYONG",0,0,0,0,0
2024,7,"KGM",0,0,0,0,0
2024,7,"MAN",0,0,0,0,0
2024,7,"CADILLAC",0,0,0,0,0
2024,7,"CHEVROLET",0,0,0,0,0
2024,7,"INFINITI",0,0,0,0,0
2024,7,"ISUZU",0,0,0,0,0
2024,7,"SUBARU",0,0,0,0,0
2024,7,"ALPINE",0,0,0,0,0
2024,7,"MAZDA",0,0,0,0,0
2024,7,"FORD",0,0,0,0,0
2024,7,"JAECOO",0,0,0,0,0
2024,8,"TOYOTA",1265,19897,2,0,21164
2024,8,"BYDAUTO",12890,0,0,0,12890
2024,8,"HYUNDAI",1682,10292,0,0,11974
2024,8,"SUZUKI",0,6081,0,0,6081
2024,8,"MG",5784,0,169,0,5953
2024,8,"KIA",2527,1134,2099,0,5760
2024,8,"TESLA",4549,0,0,0,4549
2024,8,"GEELY",3292,0,0,0,3292
2024,8,"CHERY",3202,0,0,0,3202
2024,8,"ZEEKR",1880,0,0,0,1880
2024,8,"XPENG",1752,0,0,0,1752
2024,8,"LEXUS",116,1217,314,0,1647
2024,8,"MERCEDES_BENZ",924,0,504,5,1433
2024,8,"SERES",1401,0,0,0,1401
2024,8,"ORA",1216,0,0,0,1216
2024,8,"NISSAN",0,1205,0,0,1205
2024,8,"BMW",381,0,491,0,872
2024,8,"SMART",843,0,0,0,843
2024,8,"SKODA",719,0,83,0,802
2024,8,"VOLVO",498,0,243,0,741
2024,8,"VOLKSWAGEN",662,0,0,0,662
2024,8,"AUDI",524,1,121,0,646
2024,8,"SKYWELL",547,0,0,0,547
2024,8,"WEY",0,0,454,0,454
2024,8,"RENAULT",1,450,0,0,451
2024,8,"GENESIS",397,0,0,0,397
2024,8,"FORTHING",377,0,0,0,377
2024,8,"EVEASY",375,0,0,0,375
2024,8,"LYNKCO",0,0,315,0,315
2024,8,"CUPRA",0,0,298,0,298
2024,8,"CITROEN",224,0,0,0,224
2024,8,"VOYAH",223,0,0,0,223
2024,8,"HONDA",0,221,0,0,221
2024,8,"POLESTAR",200,0,0,0,200
2024,8,"MAXUS",189,0,0,0,189
2024,8,"LEAPMOTOR",184,0,0,0,184
2024,8,"JAC",138,0,0,0,138
2024,8,"FIAT",127,0,0,0,127
2024,8,"OPEL",110,0,0,0,110
2024,8,"DS_AUTOMOBILES",5,0,90,0,95
2024,8,"LAND_ROVER",0,0,85,0,85
2024,8,"MITSUBISHI",0,0,77,0,77
2024,8,"MINI",21,0,56,0,77
2024,8,"JEEP",58,0,0,0,58
2024,8,"DACIA",0,53,0,0,53
2024,8,"WELTMEISTER",48,0,0,0,48
2024,8,"PEUGEOT",11,1,26,0,38
2024,8,"HONGQI",38,0,0,0,38
2024,8,"PORSCHE",19,0,12,0,31
2024,8,"JAGUAR",2,0,6,0,8
2024,8,"ABARTH",7,0,0,0,7
2024,8,"AIWAYS",7,0,0,0,7
2024,8,"NETA",5,0,0,0,5
2024,8,"FERRARI",0,0,4,0,4
2024,8,"SUBARU",1,0,0,0,1
2024,8,"BENTLEY",0,0,0,0,0
2024,8,"ALFA_ROMEO",0,0,0,0,0
2024,8,"SEAT",0,0,0,0,0
2024,8,"INFINITI",0,0,0,0,0
2024,8,"GMC",0,0,0,0,0
2024,8,"SSANGYONG",0,0,0,0,0
2024,8,"KGM",0,0,0,0,0
2024,8,"MAN",0,0,0,0,0
2024,8,"CADILLAC",0,0,0,0,0
2024,8,"CHEVROLET",0,0,0,0,0
2024,8,"ALPINE",0,0,0,0,0
2024,8,"ISUZU",0,0,0,0,0
2024,8,"MASERATI",0,0,0,0,0
2024,8,"MAZDA",0,0,0,0,0
2024,8,"FORD",0,0,0,0,0
2024,8,"ASTON_MARTIN",0,0,0,0,0
2024,8,"JAECOO",0,0,0,0,0
2024,9,"TOYOTA",1265,22838,2,0,24105
2024,9,"BYDAUTO",15164,0,0,0,15164
2024,9,"HYUNDAI",1817,11667,0,0,13484
2024,9,"SUZUKI",0,6952,0,0,6952
2024,9,"KIA",2547,1667,2099,0,6313
2024,9,"MG",5968,5,169,0,6142
2024,9,"TESLA",5248,0,0,0,5248
2024,9,"CHERY",3743,0,0,0,3743
2024,9,"GEELY",3613,0,0,0,3613
2024,9,"XPENG",2641,0,0,0,2641
2024,9,"ZEEKR",2081,0,0,0,2081
2024,9,"LEXUS",137,1413,324,0,1874
2024,9,"SERES",1506,0,0,0,1506
2024,9,"MERCEDES_BENZ",961,0,511,7,1479
2024,9,"ORA",1474,0,0,0,1474
2024,9,"NISSAN",0,1307,0,0,1307
2024,9,"BMW",423,0,527,0,950
2024,9,"SMART",895,0,0,0,895
2024,9,"SKODA",744,0,83,0,827
2024,9,"VOLVO",564,0,260,0,824
2024,9,"AUDI",573,1,126,0,700
2024,9,"VOLKSWAGEN",678,0,0,0,678
2024,9,"SKYWELL",586,0,0,0,586
2024,9,"WEY",0,0,532,0,532
2024,9,"RENAULT",1,454,0,0,455
2024,9,"LYNKCO",0,0,419,0,419
2024,9,"EVEASY",413,0,0,0,413
2024,9,"GENESIS",398,0,0,0,398
2024,9,"FORTHING",391,0,0,0,391
2024,9,"CUPRA",0,0,298,0,298
2024,9,"HONDA",0,286,0,0,286
2024,9,"VOYAH",248,0,0,0,248
2024,9,"CITROEN",227,0,0,0,227
2024,9,"MAXUS",213,0,0,0,213
2024,9,"POLESTAR",200,0,0,0,200
2024,9,"LEAPMOTOR",184,0,0,0,184
2024,9,"JAC",138,0,0,0,138
2024,9,"FIAT",127,0,0,0,127
2024,9,"OPEL",118,0,0,0,118
2024,9,"DS_AUTOMOBILES",6,0,95,0,101
2024,9,"LAND_ROVER",0,0,92,0,92
2024,9,"MINI",28,0,57,0,85
2024,9,"MITSUBISHI",0,0,77,0,77
2024,9,"JEEP",59,0,0,0,59
2024,9,"DACIA",0,56,0,0,56
2024,9,"WELTMEISTER",48,0,0,0,48
2024,9,"HONGQI",39,0,0,0,39
2024,9,"PEUGEOT",11,2,26,0,39
2024,9,"PORSCHE",20,0,12,0,32
2024,9,"JAGUAR",2,0,7,0,9
2024,9,"ABARTH",7,0,0,0,7
2024,9,"AIWAYS",7,0,0,0,7
2024,9,"NETA",5,0,0,0,5
2024,9,"FERRARI",0,0,4,0,4
2024,9,"SUBARU",3,0,0,0,3
2024,9,"ARCFOX",2,0,0,0,2
2024,9,"BENTLEY",0,0,0,0,0
2024,9,"ALFA_ROMEO",0,0,0,0,0
2024,9,"MAZDA",0,0,0,0,0
2024,9,"GMC",0,0,0,0,0
2024,9,"MASERATI",0,0,0,0,0
2024,9,"SSANGYONG",0,0,0,0,0
2024,9,"KGM",0,0,0,0,0
2024,9,"MAN",0,0,0,0,0
2024,9,"CADILLAC",0,0,0,0,0
2024,9,"CHEVROLET",0,0,0,0,0
2024,9,"FORD",0,0,0,0,0
2024,9,"ISUZU",0,0,0,0,0
2024,9,"ASTON_MARTIN",0,0,0,0,0
2024,9,"SEAT",0,0,0,0,0
2024,9,"INFINITI",0,0,0,0,0
2024,9,"ALPINE",0,0,0,0,0
2024,9,"JAECOO",0,0,0,0,0
2024,10,"TOYOTA",1265,24208,2,0,25475
2024,10,"BYDAUTO",15778,0,0,0,15778
2024,10,"HYUNDAI",1930,12607,0,0,14537
2024,10,"SUZUKI",0,7316,0,0,7316
2024,10,"KIA",2551,2054,2099,0,6704
2024,10,"MG",6057,10,169,0,6236
2024,10,"TESLA",5898,0,0,0,5898
2024,10,"CHERY",4037,0,0,0,4037
2024,10,"GEELY",3933,0,0,0,3933
2024,10,"XPENG",3021,0,0,0,3021
2024,10,"ZEEKR",2284,0,0,0,2284
2024,10,"LEXUS",150,1516,344,0,2010
2024,10,"SERES",1578,0,0,0,1578
2024,10,"ORA",1545,0,0,0,1545
2024,10,"MERCEDES_BENZ",980,0,516,8,1504
2024,10,"NISSAN",0,1478,0,0,1478
2024,10,"BMW",435,0,540,0,975
2024,10,"SMART",952,0,0,0,952
2024,10,"VOLVO",597,0,265,0,862
2024,10,"SKODA",754,0,83,0,837
2024,10,"AUDI",629,1,130,0,760
2024,10,"VOLKSWAGEN",707,0,0,0,707
2024,10,"SKYWELL",611,0,0,0,611
2024,10,"WEY",0,0,550,0,550
2024,10,"RENAULT",1,461,0,0,462
2024,10,"EVEASY",423,0,0,0,423
2024,10,"LYNKCO",0,0,421,0,421
2024,10,"GENESIS",399,0,0,0,399
2024,10,"FORTHING",391,0,0,0,391
2024,10,"HONDA",0,339,0,0,339
2024,10,"CUPRA",0,0,298,0,298
2024,10,"VOYAH",262,0,0,0,262
2024,10,"CITROEN",230,0,0,0,230
2024,10,"MAXUS",218,0,0,0,218
2024,10,"POLESTAR",200,0,0,0,200
2024,10,"LEAPMOTOR",184,0,0,0,184
2024,10,"JAC",144,0,0,0,144
2024,10,"FIAT",127,0,0,0,127
2024,10,"OPEL",119,0,0,0,119
2024,10,"DS_AUTOMOBILES",6,0,96,0,102
2024,10,"LAND_ROVER",0,0,100,0,100
2024,10,"MINI",35,0,57,0,92
2024,10,"MITSUBISHI",0,0,77,0,77
2024,10,"JEEP",62,0,0,0,62
2024,10,"DACIA",0,56,0,0,56
2024,10,"PORSCHE",41,0,12,0,53
2024,10,"WELTMEISTER",48,0,0,0,48
2024,10,"PEUGEOT",13,6,26,0,45
2024,10,"HONGQI",41,0,0,0,41
2024,10,"SUBARU",24,0,0,0,24
2024,10,"NETA",10,0,0,0,10
2024,10,"JAGUAR",2,0,7,0,9
2024,10,"ABARTH",8,0,0,0,8
2024,10,"AIWAYS",7,0,0,0,7
2024,10,"DONGFENG",5,0,0,0,5
2024,10,"FERRARI",0,0,4,0,4
2024,10,"ARCFOX",2,0,0,0,2
2024,10,"BENTLEY",0,0,0,0,0
2024,10,"MASERATI",0,0,0,0,0
2024,10,"MAZDA",0,0,0,0,0
2024,10,"FORD",0,0,0,0,0
2024,10,"ASTON_MARTIN",0,0,0,0,0
2024,10,"SSANGYONG",0,0,0,0,0
2024,10,"KGM",0,0,0,0,0
2024,10,"MAN",0,0,0,0,0
2024,10,"CADILLAC",0,0,0,0,0
2024,10,"CHEVROLET",0,0,0,0,0
2024,10,"ALFA_ROMEO",0,0,0,0,0
2024,10,"ISUZU",0,0,0,0,0
2024,10,"ALPINE",0,0,0,0,0
2024,10,"SEAT",0,0,0,0,0
2024,10,"INFINITI",0,0,0,0,0
2024,10,"GMC",0,0,0,0,0
2024,10,"JAECOO",0,0,0,0,0
2024,11,"TOYOTA",1265,26380,2,0,27647
2024,11,"BYDAUTO",16443,0,6,0,16449
2024,11,"HYUNDAI",2121,14112,0,0,16233
2024,11,"SUZUKI",0,7953,0,0,7953
2024,11,"KIA",2552,2638,2099,0,7289
2024,11,"MG",6194,145,169,0,6508
2024,11,"TESLA",6261,0,0,0,6261
2024,11,"CHERY",4410,0,0,0,4410
2024,11,"GEELY",4193,0,0,0,4193
2024,11,"XPENG",3624,0,0,0,3624
2024,11,"ZEEKR",2472,0,0,0,2472
2024,11,"LEXUS",166,1683,377,0,2226
2024,11,"SERES",1665,0,0,0,1665
2024,11,"NISSAN",0,1589,0,0,1589
2024,11,"ORA",1563,0,0,0,1563
2024,11,"MERCEDES_BENZ",980,0,518,8,1506
2024,11,"SMART",1029,0,0,0,1029
2024,11,"BMW",449,0,564,0,1013
2024,11,"VOLVO",642,0,265,0,907
2024,11,"SKODA",755,0,83,0,838
2024,11,"AUDI",677,1,143,0,821
2024,11,"VOLKSWAGEN",732,0,0,0,732
2024,11,"SKYWELL",635,0,0,0,635
2024,11,"WEY",0,0,568,0,568
2024,11,"RENAULT",1,475,0,0,476
2024,11,"EVEASY",444,0,0,0,444
2024,11,"LYNKCO",10,0,424,0,434
2024,11,"GENESIS",403,0,0,0,403
2024,11,"FORTHING",392,0,0,0,392
2024,11,"HONDA",0,380,0,0,380
2024,11,"CUPRA",0,0,298,0,298
2024,11,"VOYAH",274,0,0,0,274
2024,11,"CITROEN",247,0,0,0,247
2024,11,"MAXUS",223,0,0,0,223
2024,11,"POLESTAR",200,0,0,0,200
2024,11,"LEAPMOTOR",184,0,0,0,184
2024,11,"JAC",151,0,0,0,151
2024,11,"FIAT",127,0,0,0,127
2024,11,"OPEL",120,0,0,0,120
2024,11,"LAND_ROVER",0,0,105,0,105
2024,11,"DS_AUTOMOBILES",6,0,96,0,102
2024,11,"MINI",40,0,57,0,97
2024,11,"MITSUBISHI",0,0,77,0,77
2024,11,"PORSCHE",57,0,12,0,69
2024,11,"JEEP",66,0,0,0,66
2024,11,"DACIA",0,56,0,0,56
2024,11,"WELTMEISTER",48,0,0,0,48
2024,11,"PEUGEOT",13,7,26,0,46
2024,11,"SUBARU",43,0,0,0,43
2024,11,"HONGQI",42,0,0,0,42
2024,11,"NETA",10,0,0,0,10
2024,11,"JAGUAR",2,0,7,0,9
2024,11,"ABARTH",9,0,0,0,9
2024,11,"AIWAYS",7,0,0,0,7
2024,11,"DONGFENG",7,0,0,0,7
2024,11,"FERRARI",0,0,4,0,4
2024,11,"JAECOO",0,0,4,0,4
2024,11,"ARCFOX",2,0,0,0,2
2024,11,"MASERATI",0,0,0,0,0
2024,11,"MAZDA",0,0,0,0,0
2024,11,"FORD",0,0,0,0,0
2024,11,"ASTON_MARTIN",0,0,0,0,0
2024,11,"SSANGYONG",0,0,0,0,0
2024,11,"ALFA_ROMEO",0,0,0,0,0
2024,11,"MAN",0,0,0,0,0
2024,11,"CADILLAC",0,0,0,0,0
2024,11,"CHEVROLET",0,0,0,0,0
2024,11,"ALPINE",0,0,0,0,0
2024,11,"KGM",0,0,0,0,0
2024,11,"GMC",0,0,0,0,0
2024,11,"SEAT",0,0,0,0,0
2024,11,"INFINITI",0,0,0,0,0
2024,11,"BENTLEY",0,0,0,0,0
2024,11,"ISUZU",0,0,0,0,0
2024,12,"TOYOTA",1265,28681,2,0,29948
2024,12,"BYDAUTO",16690,0,8,0,16698
2024,12,"HYUNDAI",2155,14259,0,0,16414
2024,12,"SUZUKI",0,8765,0,0,8765
2024,12,"TESLA",8202,0,0,0,8202
2024,12,"KIA",2555,2822,2099,0,7476
2024,12,"MG",6276,186,169,0,6631
2024,12,"XPENG",4869,0,0,0,4869
2024,12,"CHERY",4821,0,8,0,4829
2024,12,"GEELY",4446,0,0,0,4446
2024,12,"ZEEKR",2632,0,0,0,2632
2024,12,"LEXUS",181,1771,412,0,2364
2024,12,"SERES",1729,0,0,0,1729
2024,12,"NISSAN",0,1723,0,0,1723
2024,12,"ORA",1611,0,0,0,1611
2024,12,"MERCEDES_BENZ",985,0,523,8,1516
2024,12,"SMART",1083,0,0,0,1083
2024,12,"BMW",489,0,577,0,1066
2024,12,"VOLVO",744,0,268,0,1012
2024,12,"AUDI",695,1,146,0,842
2024,12,"SKODA",755,0,83,0,838
2024,12,"VOLKSWAGEN",755,0,0,0,755
2024,12,"SKYWELL",680,0,0,0,680
2024,12,"EVEASY",593,0,0,0,593
2024,12,"WEY",0,0,577,0,577
2024,12,"RENAULT",1,486,0,0,487
2024,12,"LYNKCO",20,0,436,0,456
2024,12,"GENESIS",403,0,0,0,403
2024,12,"HONDA",0,402,0,0,402
2024,12,"FORTHING",397,0,0,0,397
2024,12,"CUPRA",1,0,298,0,299
2024,12,"VOYAH",278,0,0,0,278
2024,12,"MAXUS",254,0,0,0,254
2024,12,"CITROEN",253,0,0,0,253
2024,12,"LEAPMOTOR",203,0,0,0,203
2024,12,"POLESTAR",200,0,0,0,200
2024,12,"JAC",174,0,0,0,174
2024,12,"DS_AUTOMOBILES",10,0,118,0,128
2024,12,"FIAT",127,0,0,0,127
2024,12,"OPEL",122,0,0,0,122
2024,12,"LAND_ROVER",0,0,105,0,105
2024,12,"MINI",42,0,57,0,99
2024,12,"NETA",86,0,0,0,86
2024,12,"PORSCHE",72,0,13,0,85
2024,12,"MITSUBISHI",0,0,77,0,77
2024,12,"JEEP",67,0,0,0,67
2024,12,"DACIA",0,56,0,0,56
2024,12,"SUBARU",50,0,0,0,50
2024,12,"WELTMEISTER",48,0,0,0,48
2024,12,"PEUGEOT",13,7,26,0,46
2024,12,"HONGQI",44,0,0,0,44
2024,12,"JAECOO",0,0,23,0,23
2024,12,"FOTON",22,0,0,0,22
2024,12,"DEEPAL",20,0,0,0,20
2024,12,"DONGFENG",19,0,0,0,19
2024,12,"JAGUAR",2,0,7,0,9
2024,12,"ABARTH",9,0,0,0,9
2024,12,"SWM",8,0,0,0,8
2024,12,"AIWAYS",7,0,0,0,7
2024,12,"REHIGH",6,0,0,0,6
2024,12,"FERRARI",0,0,4,0,4
2024,12,"ARCFOX",2,0,0,0,2
2024,12,"MAN",0,0,0,0,0
2024,12,"MASERATI",0,0,0,0,0
2024,12,"GMC",0,0,0,0,0
2024,12,"MAZDA",0,0,0,0,0
2024,12,"ALFA_ROMEO",0,0,0,0,0
2024,12,"INFINITI",0,0,0,0,0
2024,12,"ALPINE",0,0,0,0,0
2024,12,"ASTON_MARTIN",0,0,0,0,0
2024,12,"BENTLEY",0,0,0,0,0
2024,12,"SSANGYONG",0,0,0,0,0
2024,12,"CHEVROLET",0,0,0,0,0
2024,12,"CADILLAC",0,0,0,0,0
2024,12,"KGM",0,0,0,0,0
2024,12,"SEAT",0,0,0,0,0
2024,12,"ISUZU",0,0,0,0,0
2024,12,"FORD",0,0,0,0,0
2025,1,"HYUNDAI",276,3245,0,0,3521
2025,1,"TOYOTA",0,3222,0,0,3222
2025,1,"MG",279,1679,0,0,1958
2025,1,"BYDAUTO",1945,0,3,0,1948
2025,1,"JAECOO",0,0,1483,0,1483
2025,1,"CHERY",601,0,562,0,1163
2025,1,"KIA",5,1038,0,0,1043
2025,1,"XPENG",901,0,0,0,901
2025,1,"LYNKCO",850,0,0,0,850
2025,1,"SUZUKI",0,815,0,0,815
2025,1,"NISSAN",0,383,0,0,383
2025,1,"LEXUS",14,249,56,0,319
2025,1,"GEELY",312,0,0,0,312
2025,1,"ZEEKR",290,0,0,0,290
2025,1,"SERES",255,0,0,0,255
2025,1,"LEAPMOTOR",204,0,0,0,204
2025,1,"MAXUS",176,0,0,0,176
2025,1,"BMW",70,0,105,0,175
2025,1,"SMART",175,0,0,0,175
2025,1,"DONGFENG",152,0,0,0,152
2025,1,"VOLVO",118,0,21,0,139
2025,1,"DEEPAL",124,0,0,0,124
2025,1,"RENAULT",0,123,0,0,123
2025,1,"HONDA",0,99,0,0,99
2025,1,"AUDI",69,0,17,0,86
2025,1,"ORA",69,0,0,0,69
2025,1,"FORTHING",61,0,0,0,61
2025,1,"JAC",54,0,0,0,54
2025,1,"MERCEDES_BENZ",8,0,37,8,53
2025,1,"CUPRA",52,0,0,0,52
2025,1,"NIO",44,0,0,0,44
2025,1,"SKYWELL",44,0,0,0,44
2025,1,"SUBARU",41,0,0,0,41
2025,1,"VOYAH",39,0,0,0,39
2025,1,"VOLKSWAGEN",35,0,0,0,35
2025,1,"PORSCHE",25,4,5,0,34
2025,1,"HONGQI",18,0,0,0,18
2025,1,"FOTON",18,0,0,0,18
2025,1,"GENESIS",16,0,0,0,16
2025,1,"MINI",13,0,0,0,13
2025,1,"JEEP",13,0,0,0,13
2025,1,"NETA",11,0,0,0,11
2025,1,"TESLA",11,0,0,0,11
2025,1,"PEUGEOT",8,0,0,0,8
2025,1,"WEY",0,0,8,0,8
2025,1,"LAND_ROVER",0,0,5,0,5
2025,1,"ALFA_ROMEO",3,0,0,0,3
2025,1,"EVEASY",1,0,0,0,1
2025,1,"DS_AUTOMOBILES",0,0,1,0,1
2025,1,"OPEL",1,0,0,0,1
2025,1,"BENTLEY",0,0,0,0,0
2025,1,"KGM",0,0,0,0,0
2025,1,"SEAT",0,0,0,0,0
2025,1,"ISUZU",0,0,0,0,0
2025,1,"SKODA",0,0,0,0,0
2025,1,"FORD",0,0,0,0,0
2025,1,"FIAT",0,0,0,0,0
2025,1,"SSANGYONG",0,0,0,0,0
2025,1,"MAZDA",0,0,0,0,0
2025,1,"CHEVROLET",0,0,0,0,0
2025,1,"ABARTH",0,0,0,0,0
2025,1,"MITSUBISHI",0,0,0,0,0
2025,1,"DACIA",0,0,0,0,0
2025,1,"CITROEN",0,0,0,0,0
2025,1,"CADILLAC",0,0,0,0,0
2025,2,"HYUNDAI",419,6057,0,0,6476
2025,2,"TOYOTA",0,6134,0,0,6134
2025,2,"BYDAUTO",2386,0,192,0,2578
2025,2,"JAECOO",0,0,2262,0,2262
2025,2,"MG",422,1813,0,0,2235
2025,2,"CHERY",934,0,829,0,1763
2025,2,"XPENG",1592,0,0,0,1592
2025,2,"KIA",8,1569,0,0,1577
2025,2,"SUZUKI",0,1221,0,0,1221
2025,2,"LYNKCO",1075,0,0,0,1075
2025,2,"LEXUS",15,488,94,0,597
2025,2,"NISSAN",0,586,0,0,586
2025,2,"ZEEKR",556,0,0,0,556
2025,2,"GEELY",495,0,0,0,495
2025,2,"DONGFENG",406,0,0,0,406
2025,2,"SERES",334,0,0,0,334
2025,2,"MAXUS",331,0,0,0,331
2025,2,"VOLVO",274,0,28,0,302
2025,2,"LEAPMOTOR",231,0,0,0,231
2025,2,"BMW",107,0,123,0,230
2025,2,"SMART",214,0,0,0,214
2025,2,"DEEPAL",184,0,0,0,184
2025,2,"RENAULT",1,147,0,0,148
2025,2,"HONDA",0,127,0,0,127
2025,2,"JAC",119,0,0,0,119
2025,2,"AUDI",99,0,20,0,119
2025,2,"ORA",99,0,0,0,99
2025,2,"FORTHING",84,0,0,0,84
2025,2,"VOLKSWAGEN",71,0,0,0,71
2025,2,"CUPRA",70,0,0,0,70
2025,2,"MERCEDES_BENZ",9,0,43,12,64
2025,2,"SKYWELL",62,0,0,0,62
2025,2,"HONGQI",60,0,0,0,60
2025,2,"VOYAH",55,0,0,0,55
2025,2,"NIO",45,0,0,0,45
2025,2,"PORSCHE",31,6,7,0,44
2025,2,"SUBARU",41,0,0,0,41
2025,2,"JEEP",39,0,0,0,39
2025,2,"FOTON",27,0,0,0,27
2025,2,"EVEASY",22,0,0,0,22
2025,2,"GENESIS",21,0,0,0,21
2025,2,"TESLA",17,0,0,0,17
2025,2,"MINI",17,0,0,0,17
2025,2,"PEUGEOT",14,0,0,0,14
2025,2,"NETA",11,0,0,0,11
2025,2,"WEY",0,0,9,0,9
2025,2,"LAND_ROVER",0,0,9,0,9
2025,2,"ALFA_ROMEO",8,0,0,0,8
2025,2,"BENTLEY",0,0,3,0,3
2025,2,"OPEL",1,0,0,0,1
2025,2,"FERRARI",0,0,1,0,1
2025,2,"ABARTH",1,0,0,0,1
2025,2,"DS_AUTOMOBILES",0,0,1,0,1
2025,2,"CADILLAC",1,0,0,0,1
2025,2,"KGM",0,0,0,0,0
2025,2,"SKODA",0,0,0,0,0
2025,2,"SEAT",0,0,0,0,0
2025,2,"SSANGYONG",0,0,0,0,0
2025,2,"FORD",0,0,0,0,0
2025,2,"ASTON_MARTIN",0,0,0,0,0
2025,2,"CHEVROLET",0,0,0,0,0
2025,2,"CITROEN",0,0,0,0,0
2025,2,"ISUZU",0,0,0,0,0
2025,2,"DACIA",0,0,0,0,0
2025,2,"FIAT",0,0,0,0,0
2025,2,"MAZDA",0,0,0,0,0
2025,2,"MITSUBISHI",0,0,0,0,0
2025,3,"TOYOTA",0,9255,0,0,9255
2025,3,"HYUNDAI",526,8662,0,0,9188
2025,3,"BYDAUTO",2806,0,622,0,3428
2025,3,"JAECOO",0,0,3138,0,3138
2025,3,"MG",1140,1859,0,0,2999
2025,3,"CHERY",1205,0,1127,0,2332
2025,3,"XPENG",2220,0,0,0,2220
2025,3,"KIA",8,2064,0,0,2072
2025,3,"NISSAN",0,1893,0,0,1893
2025,3,"SUZUKI",0,1555,0,0,1555
2025,3,"LYNKCO",1276,0,0,0,1276
2025,3,"LEXUS",15,754,115,0,884
2025,3,"GEELY",854,0,0,0,854
2025,3,"ZEEKR",751,0,0,0,751
2025,3,"DONGFENG",609,0,0,0,609
2025,3,"VOLVO",475,0,49,0,524
2025,3,"TESLA",459,0,0,0,459
2025,3,"SERES",424,0,0,0,424
2025,3,"MAXUS",416,0,0,0,416
2025,3,"LEAPMOTOR",410,0,0,0,410
2025,3,"BMW",220,0,143,0,363
2025,3,"SMART",316,0,0,0,316
2025,3,"DEEPAL",241,0,0,0,241
2025,3,"AUDI",167,0,40,0,207
2025,3,"HONGQI",190,0,0,0,190
2025,3,"RENAULT",1,173,0,0,174
2025,3,"JAC",169,0,0,0,169
2025,3,"HONDA",0,160,0,0,160
2025,3,"ORA",126,0,0,0,126
2025,3,"FORTHING",110,0,0,0,110
2025,3,"VOLKSWAGEN",101,0,0,0,101
2025,3,"CUPRA",90,0,0,0,90
2025,3,"SKYWELL",80,0,0,0,80
2025,3,"MERCEDES_BENZ",11,0,56,12,79
2025,3,"VOYAH",74,0,0,0,74
2025,3,"NIO",62,0,0,0,62
2025,3,"PORSCHE",35,11,8,0,54
2025,3,"JEEP",50,0,0,0,50
2025,3,"SUBARU",41,0,0,0,41
2025,3,"EVEASY",41,0,0,0,41
2025,3,"FOTON",40,0,0,0,40
2025,3,"MINI",33,0,0,0,33
2025,3,"GENESIS",27,0,0,0,27
2025,3,"DACIA",1,25,0,0,26
2025,3,"PEUGEOT",16,0,0,0,16
2025,3,"LAND_ROVER",0,0,14,0,14
2025,3,"NETA",13,0,0,0,13
2025,3,"ALFA_ROMEO",13,0,0,0,13
2025,3,"WEY",0,0,10,0,10
2025,3,"BENTLEY",0,0,5,0,5
2025,3,"FERRARI",0,0,2,0,2
2025,3,"ABARTH",2,0,0,0,2
2025,3,"DS_AUTOMOBILES",0,0,1,0,1
2025,3,"CADILLAC",1,0,0,0,1
2025,3,"OPEL",1,0,0,0,1
2025,3,"AVATR",1,0,0,0,1
2025,3,"FIAT",0,0,0,0,0
2025,3,"CITROEN",0,0,0,0,0
2025,3,"MAZDA",0,0,0,0,0
2025,3,"FORD",0,0,0,0,0
2025,3,"MITSUBISHI",0,0,0,0,0
2025,3,"SKODA",0,0,0,0,0
2025,3,"SEAT",0,0,0,0,0
2025,3,"KGM",0,0,0,0,0
2025,3,"SSANGYONG",0,0,0,0,0
2025,3,"CHEVROLET",0,0,0,0,0
2025,3,"ISUZU",0,0,0,0,0
2025,3,"ASTON_MARTIN",0,0,0,0,0